8449 = 8449 <8449>
aaime = aaime <aaime>
aboudreault = aboudreault <aboudreault>
activityworkshop = activityworkshop <activityworkshop>
aghisla = aghisla <aghisla>
alfonx = alfonx <alfonx>
amuriy = amuriy <amuriy>
amygao = amygao <amygao>
anton = anton <anton>
arargyridis = arargyridis <arargyridis>
arnulf = arnulf <arnulf>
asantiago = asantiago <asantiago>
astrid_emde = astrid_emde <astrid_emde>
barryrowlingson = barryrowlingson <barryrowlingson>
bbinet = bbinet <bbinet>
blammo = blammo <blammo>
bretschneider = bretschneider <bretschneider>
bukun = bukun <bukun>
bullet = bullet <bullet>
camerons = camerons <camerons>
crschmidt = crschmidt <crschmidt>
ctuffery = ctuffery <ctuffery>
darkblueb = darkblueb <darkblueb>
dassau = dassau <dassau>
djay = djay <djay>
dkastl = dkastl <dkastl>
dodo = dodo <dodo>
drewnak = drewnak <drewnak>
edso = edso <edso>
ehjuerrens = ehjuerrens <ehjuerrens>
elena = elena <elena>
epifanio = epifanio <epifanio>
erikapillu = erikapillu <erikapillu>
erilem = erilem <erilem>
etdube = etdube <etdube>
eyedol = eyedol <eyedol>
fgdrf = fgdrf <fgdrf>
flavour = flavour <flavour>
friedjoff = friedjoff <friedjoff>
fschindler = fschindler <fschindler>
fxp = fxp <fxp>
getux81 = getux81 <getux81>
gislars = gislars <gislars>
guygriffiths = guygriffiths <guygriffiths>
halsk = halsk <halsk>
hamish = hamish <hamish>
hernanolivera = hernanolivera <hernanolivera>
hobu = hobu <hobu>
hychoe = hychoe <hychoe>
ian = ian <ian>
ianturton = ianturton <ianturton>
ingenieroariel = ingenieroariel <ingenieroariel>
iqnaul = iqnaul <iqnaul>
iwasaki = iwasaki <iwasaki>
jachym = jachym <jachym>
jbryant = jbryant <jbryant>
jimk = jimk <jimk>
jive = jive <jive>
jldominguez = jldominguez <jldominguez>
jmays = jmays <jmays>
jmckenna = jmckenna <jmckenna>
jng = jng <jng>
johanvdw = johanvdw <johanvdw>
jrodrigo = jrodrigo <jrodrigo>
jsanchez = jsanchez <jsanchez>
jsanz = jsanz <jsanz>
jvhigon = jvhigon <jvhigon>
jwilden = jwilden <jwilden>
kalxas = Angelos Tzotsos <gcpp.kalxas@gmail.com>
klokan = klokan <klokan>
kristoflange = kristoflange <kristoflange>
KristofLange = KristofLange <KristofLange>
larrysh = larrysh <larrysh>
lucadelu = lucadelu <lucadelu>
madair = madair <madair>
madi = madi <madi>
Magepa = Magepa <Magepa>
manuelgrizonnet = Manuel Grizonnet <manuel.grizonnet@cnes.fr>
marcocur = marcocur <marcocur>
marcopoldo = marcopoldo <marcopoldo>
mbarbeau = mbarbeau <mbarbeau>
mentaer = mentaer <mentaer>
micha = micha <micha>
michaudm = michaudm <michaudm>
milenaN = milenaN <milenaN>
MilenaN = MilenaN <MilenaN>
misev = misev <misev>
mleslie = mleslie <mleslie>
moovida = moovida <moovida>
mowonibi = mowonibi <mowonibi>
mpazos = mpazos <mpazos>
nedhorning = nedhorning <nedhorning>
neteler = neteler <neteler>
nuimura = nuimura <nuimura>
olt = olt <olt>
oscarfonts = oscarfonts <oscarfonts>
phaf = phaf <phaf>
pieterdg = pieterdg <pieterdg>
pka = pka <pka>
pmeems = pmeems <pmeems>
rantolin = rantolin <rantolin>
rasdaman = rasdaman <rasdaman>
rdewit = rdewit <rdewit>
rediguana = rediguana <rediguana>
robe = robe <robe>
rpinho = rpinho <rpinho>
rscsgis = rscsgis <rscsgis>
sanak = sanak <sanak>
sbcalvo = sbcalvo <sbcalvo>
schpidi = schpidi <schpidi>
scottp = scottp <scottp>
sdlime = sdlime <sdlime>
sergobot = sergobot <sergobot>
shansen = shansen <shansen>
siki = siki <siki>
simonp = simonp <simonp>
songcn = songcn <songcn>
springmeyer = springmeyer <springmeyer>
spross = spross <spross>
streulma = streulma <streulma>
surveyor = surveyor <surveyor>
tanner = tanner <tanner>
tbadard = tbadard <tbadard>
Tbadard = Tbadard <Tbadard>
tbaschetti = tbaschetti <tbaschetti>
thomasg = thomasg <thomasg>
ticheler = ticheler <ticheler>
tomkralidis = tomkralidis <tomkralidis>
tosseto = tosseto <tosseto>
trevorwekel = trevorwekel <trevorwekel>
trochej = trochej <trochej>
vehrka = vehrka <vehrka>
vmische = vmische <vmische>
warmerdam = warmerdam <warmerdam>
wildintellect = wildintellect <wildintellect>
yoichi = yoichi <yoichi>
